01000000000010000000000000000010000000000000000000
00000000000000100000000000000000000000001001000000
00000000010011000000000000000101001010100010100000
00000100000000000000000000001000000000000000100110
00000000000010000100010000000000000000000000000000
00000000001100000000000000000000000000010000010000
10001000100000001000000001000010000001000000010000
01000010001000000100000100010100010100001000000001
00000000000100000000010000100000000000000000000100
00001000000000010000000000000000100110000000010000
01010000001000000000000000000000000000000110010000
00100010000000000000000000000000000000010000000000
00000100000000100000000100000001000000000000000000
00000100000000100000000000000010000000000100000000
00010000000000000100000001000000000010000000000001
00010000000000000000001000000001000000000000000010
01101000000000100000110000000000000000000000100000
01000010000000000000000000000000000000000000000110
00000000001000000000000000000000000000000010001000
00000000000000000000000010110000000000000100000110
00000001000000000000000100000000000100000100100000
00000000000000010000001010000010000001000000100001
00000100000000000000000000000000000010000000000000
00000000000000000010000000000000000000000000000000
00000010000000101000000000000000100000001000000000
10000000000000000000000000000101000000100000000000
00101100000010001100000010000000010000101000000000
00000010010000011100000000000000100000000001110001
01000000000000000000010000000000000010000010000100
00101000000000000000000000001000000000000010000000
00000000000000001000110000000000010000000000000000
00000000000000010001000000100000000000000000000000
01000000000000000000001000000000001000011000000000
11000000000000000000000000000000010000010000000000
00000000000000000000100000001010000000000001000000
00000010000000000000000000000000000000000000000000
01100000000000000001000000010000000100000000010000
10100000010000000000000000000000000000000000000000
00100000000000000000000000010101100000000000000000
00110010000010000000100000000000011000100000000000
00000100000000000000010000000000000000000000010000
00010100000001000000000000000100000001000000001001
01100000000000000000000000010000010000100000100001
00100000000000000001000000000000000010000000000000
00000000000000000000000000000000000100000000000000
10000000000000000000000000100100000000010000000000
00000000000000000000000000000000000000000100000000
00000010000000000000010000000000000000000101000010
01000100000000110000000111000000000000000010000000
01000000001000100000101000000000000000000000001000
