00000000000000000
00000000000000000
00001110001110000
00000000000000000
00100001010000100
00100001010000100
00100001010000100
00001110001110000
00000000000000000
00001110001110000
00100001010000100
00100001010000100
00100001010000100
00000000000000000
00001110001110000
00000000000000000
00000000000000000

