00000010010
00100001110
00100001000
00100010010
00000101100
00000010000
10100001010
10101001010
10000000110
00010111010
