0111101001110111101111111100110100101011110010110111101111001111111000001011111111011111011111110101
1101100011010101110111001011001111111111011111111111010111110111001111111100110110111101110111010011
1110010110100111101110101101110101111011110011111101011011000011010010101011111111111101000101111001
1110001111110100111010101111111011010111010111111111001110011011111111110011111111111110010111111111
0100001111111111111111111101111110101011111101011001111110011111110111110011011111100011000011101011
1111111100110011111011010111111101011111111011011111110110110110100001110111101111110111111001101111
1101111111111100011110110111011111111111111111111100111010111100110111000101110111110111011100101110
1111001101111111011111011010001110010011101111101011011110101110111011100101010101111111111111111110
1110111111010001111011011001101001110011101110011110011111011101110111111111101101111111111101111011
0110110110100111011001011100111101110100001101111111111011111111100011010101011101110110111111100110
1001111100111010111111001100011111010011101101111101101111011110111110011010001111010001011100011011
1010111111111111111100010111111111110101110111111111111101110000101101000111101001011101110111101111
0010101010111111110011111111101110111111011100111001101101110111111111110101111111111100000111111111
1010111111111110110011110110111011011011110010101111101111011011011110100011010101010001111111001111
0111011000111001111011100110110111011111010111111101111110101110111011101101000101111111111101101111
1010101111111111110111001111010000111111011010110001110100110101100001110111101111100110111000111111
1111101011110101011101011110100011110011001101010110111101111111110111001110011100011100011111111110
1111011111111000110010101001111111001010111111111101111001110011100111101111110011000111101100100000
1011110110111011111111000110011001011110111111111110111111111110001111111011010110111101111111101111
1011001111100011110101101111010101101101110111111101100101101011101111010010010100011110011111101100
1011100110001011101111111001110111110011011001111111101011111100011011010111101110111111100111100110
0101111101101100010000011111101111011100111100011110111111111111111110100110110111111111111001110001
0011111101001000111111110101110011111101010011001101110101101111100110001101111011101011111100111111
1111111111001111110000100001100101101111111011000010111011111101111001000110001110111001101010111110
1111111001100111110101101011111110100111011110111100101111101111110111100011111011011101101000010111
1110000010110100110111110111111010111011111111000111110010111111101110100111110010010111001111110111
1111011111011110011011011110000111110111111101010110011011101101011101100111111110111111111110010001
1110100101000011110110011111110100001111111001101111111110110110010101101011101101111110010001111001
1011110101111010011011101110010100111011110101111111111101111110100011100110101100110000101111000011
1111010111100111100110111110111011111011111111111101111111011110111001101110100001111001111111010111
1111011010101101010111111101011111111110001101011101101010001011010010101111011111111111111110111101
1111111111100111111111111111100011101111111101011111111100101101111111011101111010001110011011011101
1101101011011111111111101100111011111111111110011111101100111111000101111101011101011101111101111010
1111101001010100111100111110010011111110101110011011011111101011000101101110110100010111111111111110
1111001111100001101110111011001101101111100111101101011100100111101000011011000110101101110101110101
1111101011110101111111111111001111111111011101011101111110111100101110111100110011100111111010011101
1001011001111001111000111111100110111110011011011111111101101101101111010101101000110111011011111111
1111001101111111111111110110110111011101110101011111100111101110010101111000111110001111111111001011
1101011001101011110111000111111111110000011110011111101011011101110010111011011011101111111101011111
0111000101111111101111011110111111110111111110111111110111011111001001100011110101111111110111111101
0111001101110101010111111011111110100111111110011110111111111111110001100010101011111111100101111110
1001010110011101101111011101011111111001111111010001111011011111110111111100101000111111010111111011
1000111111111111101111010111110111111011111111010111001101010011100111011110111101111110011111101011
1101100011110111110011100111011101111110111111111111110111110011101011111101111100010100011011111110
0101111011111011110010001110011010101111001010010101011010101111010110101111111010100110001111110111
1011100011011011101110110111111101111111101111111111111110111101011111101100101010011011111111110100
1111011010111111001010011101011110111111111101100101101011111011111101111111111110110111101100111100
1011101111011111101001010011011011110011111001111010111111101111111111111101111011011110101011101111
1111101111110010110100111111111101111101010010110110111111011111110111111111010110111101111111111110
0110011111101111111111001111111111101100111101100101001000111101110101011010110111111111011111011011
1100111111010110111110011110111111110110010110111101011111001101010111100100011101111110100011111110
1011111110111011101111111011101111001101110001010110001111110011101011111111100110111111010111111001
1000110101011110111101011010111011011110100111111101101110111001101111000001111000011100010001110010
1111001110011010111101111111110111010011110111111110101011101111101101111111110101111111101111111011
1011110110001101011111111000010010110111101010111101111010100010111110010101111111011110100111111111
0111011010110001111011111111011110111011111011101011111101100001111111110100110110000110111001110111
1111110111111001011111011001111011111111111111101001111111110001111110001011110101101110011011111100
1111110111001001010011011100101101001010110110111110111110010011111101111100000010111101011110011110
0101010110010101110110111101110101111111111000011111100011001000110111110111110101100111011111111110
1011111011100101011100011101111011010111011111111010111001111011111110011111011101101101110111001101
0111101110111111101111111111011001100011111010111100111011010101011011101001111110011111111001011111
1101011101011101101010110011111011110011010011011001111011111110101110011110001101110111100011111100
1111000110111101111111111100010100011110111111100011110111110111101001111011010110111111101110001111
1111011001101111001111111110011110111111011000011010011001011010111101110101110011011000111101001000
1111110111111111101111110010010111111111111111111000011110010110100101011011110110111111101100101111
0101001101111110111110010111100101101111101101010111111011111111110111110011011100100100011111001111
1110010010000010111000111111011110100111111111100001101111011011111111110011111100101111111001001100
0010111111000010111111010100100000110110100110111101010111111100101111110111010111111011011110111101
1100111100011111010111100111111110111001111110101110111111111110000011110011110111011111111000111101
1111110111111001110111111111111111101010101110101110100111001101110111101110101111011101111111111111
1111111111100111110111101011011111110010110111100011010110010110111000100111110110111111011000111011
0010100011111011011111111111110111000110111110111111110101110100101101110111101011101110101010011011
1111111101100011100010111111111011111110011111101011000110111101110001001100011101110011100011001011
1110111010001111001101111111101011110001010100011111111000101011111111110111111001010110011010101101
1110111111010101100101111001111001001001101100111110110101011010010111101001101111110010111001110110
1000111111111000110100000011110100001011111111111111110111101101100111101111110110111011111101001011
0100100111111111111101110011111011011011111110110010111110001110100111111110110000101101111111101111
1111100111101011110111110111100101111101101111011000110110111111110111111110111101111111111111100111
1011101110011110011101111111100111011111111010101010111011100111111010110100111100111110111111101111
1111110101010010101101111111110111111101010011111001110111111111010101101100111011011010000111000110
1101111101011110011111111111111100001001110100010100111111111101110000011101001000101111100110111110
0110111110101100111011100101110111111001111111001010111010111111111110111011111110111010111111110111
0011111001101111011111011101110101011111111111111111111101111011001111111010001010011111101110111000
1001100101110111111011100111000001111001111011101010001111010111101000011101101111111111110011110010
1011000111011111011111110101111101111011011000111110010011111110101111100011111111111100011011110101
1100110111011011100011100111111110110111110011111111110110111111011111100010110111001101111001110011
1101111111110001111110111011101011011101110111001111111100100010101111111101100010111101011100001111
0010101011010111101101101110111110111111111111111011010111011100111111101011111111111111001010011011
0000000111111011100101111011101101011011111111110011101110111101101101111011111011011111110110101111
0110111111110111011001011011101010110110111011011111111011110111111110011111101101110101101011111100
1111110001110111101011110111011111111011001111111101100011100111111101110100111111110111011100101111
0111100100111111101110110101111010111010001111111111011111011111101111010110111011011111001100110011
1111101101011001111011010011011101111011111100101111100001110011111100111111111111111111101100010111
0101110011111110110110101111011011001111111110001000010110100100011110110011101111111100110101011111
0110111111001111100001101111011100011100000010001110001011110111011111110111111111011110011011010111
0101101110111111001110011111011001101110111111011111111111101101101111001100110101111010101101010111
0111110110011111110110110111111111111111101111100101000110111011110111111010101111111101111111101111
1111001011110100111010111101111011011101010100001110111110111111100101111101101111110011010011111001
0110010101111110011110100111110111111010111111101011010011011110110111111010000111110101111101101111
1110111101001011011010111101011111101111101101110100111110110111110000010100100011101111001111101101
